########################################
#    #         #                       #
#  ###         #                       #
#    #    #    ######    ##########    #
###  #    #    #         #        #    #
#    #    #              #   #    #    #
#  ###    #              #   ###########
#    #    #########      #        #    #
###  #            #      #        #    #
#    #            #      #####    #    #
#  ###    ####    #                    #
#    #       #    #                    #
#    #       #    #######   #          #
#    #########    #         #          #
#                 #         #          #
########################################
